1111111111111111111111111
1P00000000000000000000001
1000000000000000000000001
1000001000000000000000001
1000001000000000000000001
100000000000000E000000001
1000001000000000000000001
1000000I00000000000000001
1000000000000000000000001
1000000000000000E00000001
1000001000000000000000001
100000100000000E000000001
1000000000000000000000001
1000000E00000000000000001
1000000000000000I00000001
1000000000000000000000001
1000000000000000000000001
1000000000000000I00000001
1000000000000000000000001
100000E0000I0000000000001
1000000000000000000000001
1000000000000000000000001
1000000000000000000000001
1000000000000000000000001
1111111111111111111111111